10
11
9 5 5 5 5 1 5 7 13 3
10 9 5 5 5 4 5 5 3 10
10 8 5 5 3 13 5 5 6 10
10 10 9 7 8 5 5 5 5 2
10 10 12 5 4 5 5 5 5 2
10 8 5 5 5 5 5 5 3 10
10 10 13 5 1 5 5 7 10 10
8 0 5 5 4 5 5 5 2 10
14 12 5 5 1 5 5 7 10 10
9 5 5 7 8 5 5 5 6 10
12 5 5 5 4 5 5 5 5 6
ghost 0 0 2 red
ghost 9 0 2 pink
ghost 0 10 0 cyan
ghost 9 10 0 orange
tag 5 0 3 barcode-N
tag 9 5 0 barcode-E
tag 5 9 1 barcode-S
tag 0 5 2 barcode-W
