10
10
9 1 1 1 1 1 1 1 1 3
8 0 2 12 4 4 6 8 0 2
8 0 0 1 1 1 1 0 0 2
8 0 0 0 0 0 0 0 0 2
10 10 10 10 10 10 10 10 10 10
10 10 10 10 10 10 10 10 10 10
10 10 10 10 10 10 10 10 10 10
10 10 10 10 10 10 10 10 10 10
8 0 0 0 0 0 0 0 0 2
12 4 4 4 4 4 4 4 4 6
ghost 4 1 0 red
ghost 5 1 0 pink
ghost 6 1 0 cyan
ghost 7 1 0 orange
pacman 4 9 0
