10
10
9 1 1 1 1 1 1 1 1 3
8 0 4 4 0 0 0 0 0 2
8 2 9 3 8 2 8 2 8 2
8 2 8 2 8 2 8 2 8 2
8 0 0 0 0 0 0 0 0 2
8 0 4 4 4 4 4 4 0 2
8 0 1 3 9 1 1 3 8 2
8 0 0 2 8 0 0 2 8 2
8 2 8 0 0 2 8 0 0 2
12 6 12 4 4 6 12 4 4 6
